ls
                                
                           	    
                           	    
  @@@@@@@@@@@@@@@@@@@@@@@@@@@@  
  @............##............@  
  @.####.#####.##.#####.####.@  
  @*#  #.#   #.##.#   #.#  #*@  
  @.####.#####.##.#####.####.@  
  @..........................@  
  @.####.##.########.##.####.@  
  @.####.##.########.##.####.@  
  @......##....##....##......@  
  @@@@@@.##### ## #####.@@@@@@  
       @.##### ## #####.@       
       @.##    &     ##.@       
       @.## ###--### ##.@       
@@@@@@@@.## #      # ##.@@@@@@@@
@+      .   #& & & #   .      +@
@@@@@@@@.## #      # ##.@@@@@@@@
       @.## ######## ##.@       
       @.##          ##.@       
       @.## ######## ##.@       
  @@@@@@.## ######## ##.@@@@@@  
  @............##............@  
  @.####.#####.##.#####.####.@  
  @.####.#####.##.#####.####.@  
  @*..##.......?........##..*@  
  @##.##.##.########.##.##.##@  
  @##.##.##.########.##.##.##@  
  @......##....##....##......@  
  @.##########.##.##########.@  
  @.##########.##.##########.@  
  @..........................@  
  @@@@@@@@@@@@@@@@@@@@@@@@@@@@  
                                
                                
le